English words

# A

- abate->和らぐ、治まる
- abide->従う、順守する
- abrasive->研磨材
- admonish->～に忠告する、～を諭す
- adversary->敵、対戦相手
- adversity->逆境、災難
- chaotic->混沌とした
- agent->媒介、作用物質
- agitate->扇動する、動揺させる
- agile->機敏な、頭がさえている
- alchemist(アーカメスト)->錬金術師
- alloy->合金
- allure(アローア)->魅惑する、誘い込む
- ambush->待ち伏せて急襲する
- anguish->苦悩、苦痛
- annex->別館、離れ
- antibiotics->抗生物質
- antipathy->嫌悪、反感
- apathetic->無関係な、冷淡な
- apparatus->装置、器具
- apprentice（アプレンティス）->見習い、実習生
- appropriation->割り当て、充当金
- aquifer->帯水層
- ardent->熱心な
- ardor->熱心、熱意
- arson->放火（罪）
- ascendency->優位、支配
- attrition->（人口などの）自然減、消耗
- avalanche->雪崩
- aviator->飛行士

# B

- babble->片言でぶつぶつ言う
- bandit->賊
- beep->警告音
- billくちばし
- bracket->階層

# C

- capricious->気まぐれな、移り気
- carve->彫る、刻む
- casualty->死傷者
- choreograph->振り付けをする
- choromosome->染色体
- circuitry->回路網
- circuitous->回りくどい
- cohesive->結合力のある
- combustible->可燃性の
- commemorate->記念する
- commotion->騒動
- complement->補完する、補足する
- comprehensive->包括的な
- compulsory->強制的な、必須の
- condone->許す、大目に見る
- confiscate->押収する
- configuration->配置、構成
- Confucianism->儒教(孔子の教え)
- congested->混雑した
- congregate->集まる
- convent->修道院
- corrosive->腐食性の、むしばむ
- creditable->立派な、称賛に値する
- cumbersome->扱いにくい、厄介な
- cuneiform->くさび形の
- curfew->門限
- cylindrical->円筒形の
- clandestine->秘密の、内密の

# D

- dangle->ぶら下がる
- decompose->分解する
- decree->法令
- defy->反抗する
- demise->死去、終焉
- denounce->非難する、公然と批判する
- deplore->非難する、遺憾に思う
- despicable->いやしむべき
- desolate->荒廃させる
- desperate->必死の
- despicable->卑劣な
- detergent->洗剤
- detonate->爆発する
- depression->不景気、うつ病
- devastate->困惑させる、打ちのめす
- devotee->熱心な支持者、信奉者、愛好者
- dexterous->器用な、巧妙な
- diarrhea->下痢
- diabetic->糖尿病の
- dilute->希釈する
- dim->薄暗くする
- diploma->卒業証書
- discern->見分ける、識別する
- discord->不和、争い
- discourse->講演、談話
- discretion->裁量、思慮分別
- disdain->軽蔑する
- dismantle->分解する、解体する
- dislocate->脱臼させる
- dispensary->診療所
- disposition->(人の)性質、傾向
- dissolution->解散、溶解、分解
- distill->蒸留する
- divergent->分岐する
- diversification->多様化,多角化
- domain->領域、分野
- dormant->休眠状態の
- dorsal->背中の
- dune->砂丘
- droplet->点滴注射
- drowsiness->眠気

# E

- eclectic->多様な、折衷的な、取捨選択の
- economize->節約する
- edible->食用の
- elastic->弾力のある
- ellipse->楕円
- enlighten->啓発する、教える
- embezzle->横領する
- embryo->胚、胎児
- engrave->彫る、刻む
- eradicate->根絶する、消滅させる
- erect->直立させる
- evaporate->蒸発する
- evasion->回避、言い逃れ
- exacerbate->悪化させる
- exasperate->激怒させる
- excavate->発掘する
- exceedingly->非常に、極度に
- extierminate->根絶する、絶滅させる

# F

- fabricate->製造する、捏造する
- facet->側面、面
- faction->派閥、党派
- fathom->理解する、見抜く
- ferment->発酵する
- fern->シダ植物
- fertilization->受精、肥料を与えること
- fiasco->大失敗
- flammable->可燃性の
- flaw->欠陥、傷
- flora->植物相、植物群
- flunk->落第する、逃げる
- focal->焦点の、中心の
- foreshadow->前兆となる、予想される
- fortify->要塞化する、防備を固める
- fowl->家禽、鳥類
- frail->もろい、壊れやすい
- framer->立案者、起草者
- frigid->極寒の、非常に冷たい

# G

- gadget->装置、器具
- gargle->うがいをする
- garnish->飾る、装飾する
- geophone->地震計
- genial->親切な、愛想の良い
- germinate->発芽する
- gopher->モグラ,ホリネズミ
- graceful->優雅な、上品な

# H

- haggle->値切る、交渉する
- hamper->妨げる
- harass->嫌がらせをする
- heed->注意を払う、耳を傾ける
- heritage->遺産、伝統
- heyday->最盛期、全盛期
- homogeneous->均質の、同質の
- hippopotamus->カバ
- huddle->群がる、寄り集まる
- hue->色合い、色調

# I

- illiterate->読み書きのできない
- immaculate->汚れのない、清潔な
- impartial->公平な、偏りのない
- impecunious->貧乏な、無一文の
- impeding->妨げる、邪魔する
- impending->差し迫った、今にも起こりそうな
- imperceptible->知覚できない、気づかない、微細な
- improvise->即興で作る、即席に作る
- impudent->厚かましい、生意気な
- imprudent->軽率な、無分別な
- inadvertent->不注意な、うっかりした
- incompatible->両立しない、相容れない
- incongruous->不調和な、場違いな
- inconsiderate->思いやりのない、無分別な
- indefinite->無限の、不確定な、不明瞭な
- indelible->消せない、忘れられない
- indigenous->土着の、先住の
- indigestion->消化不良
- indigent->貧しい、貧困な
- indulgence->甘やかすこと、放縦
- infamous->悪名高い
- infiltrate->浸透する、潜入する
- inflammation->炎症を起こす、扇動的な
- infrared->赤外線の
- integral->不可欠な、完全な
- intestine->腸
- intermittent->断続的な
- interstellar->星間の
- intrinsically->本質的に
- insolent->無礼な、横柄な
- insipid->味気ない、無味乾燥な
- instantaneous->即時の、瞬間的な
- insurmountable->克服できない
- invincible->無敵の、打ち勝てない
- itchy->かゆい
- itinerant->巡回する、移動性の
- irreparable->修復できない、修復できない
- irrigate->灌漑する、水を引く
- irritability->怒りっぽさ、短気

# J

- jeopardy->危険、危難
- jolt->急激な衝撃、揺らす

# K

- keen->鋭い、熱心な

# L

- lacquer->漆、ニス
- lament->嘆く、悲しむ
- lava->溶岩
- lax->緩い、厳格でない
- lethal->致死の
- levity->軽率、軽薄
- liability->責任、義務
- lyre->堅琴

# M

- maize->トウモロコシ
- magnanimous->寛大な
- makeshift->間に合わせの、応急の
- malnutrition->栄養失調
- motley->雑多な、寄せ集めの

# N

- nebulous->曖昧な、はっきりしない

# O

- obsolete->廃れた、時代遅れの

# P

- parch->乾燥させる、干からびさせる

# Q

- quench->消す、鎮める

# R

- rancid->腐った、悪臭のする

# S

- savvy->精通している、物知りの
- stain->染み（染みをつける）、汚れ(汚す)

# T

- teem->満ちている、あふれている
- tutoring->家庭教師

# U

- uncanny->不思議な、異常な

# V

- venerate->崇敬する、尊重する

# W

- wane->衰える、減少する

# X

- xenophobia->外国人嫌悪、排外主義

# Y

- yoke->くびき、支配

# Z

- zeal->熱意、熱心な